WWWWWWWWWWWWW
WPPPPPPPPPPPW
WP         PW
WP         PW
WD         PW
WP         PW
WP         PW
WPPPPPPPPPPPW
WWWWWWWWWWWWW
