WWWWWWWWWWWWWWWWWWWWWWWWW
WPPPPPPPPPPPDPPPPPPPPPPPW
WP                     PW
WD                     DW
WP                     PW
WPPPPPPPPPPPPPPPPPPPPPPPW
WWWWWWWWWWWWWWWWWWWWWWWWW
