**WWWWWWWWW
WWWPPDPPPPW
W         W
W         W
WPPSPPPPPPW
WW   WWWWWW
WWWDWW
