****WWDWW
WWWWW   WWWWW
WPPPPPSPPPPPW
WP         DW
WP         PW
WP         PW
WPPPPPDPPPPPW
